BRCA1	Hereditary breast and ovarian cancer
BRCA1	Hereditary breast and ovarian cancer
TP53	Li-Fraumeni syndrome
STK11	Peutz-Jeghers syndrome
MLH1	Lynch syndrome
MSH2	Lynch syndrome
MSH6	Lynch syndrome
PMS2	Lynch syndrome
APC	Familial adenomatous polyposis
MUTYH	MYH-associated polyposis; adenomas, multiple colorectal, FAP type 2; colorectal adenomatous polyposis, autosomal recessive, with pilomatricomas
VHL	Von Hippel-Lindau syndrome
MEN1	Multiple endocrine neoplasia type 1
RET	Multiple endocrine neoplasia type 2
RET	Familial medullary thyroid cancer
PTEN	PTEN hamartoma tumor syndrome
RB1	Retinoblastoma
SDHD	Hereditary paraganglioma-pheochromocytoma syndrome
SDHAF2	Hereditary paraganglioma-pheochromocytoma syndrome
SDHC	Hereditary paraganglioma-pheochromocytoma syndrome
SDHB	Hereditary paraganglioma-pheochromocytoma syndrome
TSC1	Tuberous sclerosis complex
TSC2	Tuberous sclerosis complex
WT1	WT1related Wilms tumor
NF2	Neurofibromatosis type 2
COL2A1	EhlersDanlos syndrome, vascular type
FBN1	Marfan syndrome, Loeys-Dietz syndromes, and familial thoracic aortic aneurysms and dissections
TGFBR1	Marfan syndrome, Loeys-Dietz syndromes, and familial thoracic aortic aneurysms and dissections
TGFBR2	Marfan syndrome, Loeys-Dietz syndromes, and familial thoracic aortic aneurysms and dissections
SMAD3	Marfan syndrome, Loeys-Dietz syndromes, and familial thoracic aortic aneurysms and dissections
ACTA2	Marfan syndrome, Loeys-Dietz syndromes, and familial thoracic aortic aneurysms and dissections
MYLK	Marfan syndrome, Loeys-Dietz syndromes, and familial thoracic aortic aneurysms and dissections
MYH11	Marfan syndrome, Loeys-Dietz syndromes, and familial thoracic aortic aneurysms and dissections
MYBPC3	Hypertrophic cardiomyopathy, dilated cardiomyopathy
MYH7	Hypertrophic cardiomyopathy, dilated cardiomyopathy
TNNT2	Hypertrophic cardiomyopathy, dilated cardiomyopathy
TNNI3	Hypertrophic cardiomyopathy, dilated cardiomyopathy
TPM1	Hypertrophic cardiomyopathy, dilated cardiomyopathy
MYL3	Hypertrophic cardiomyopathy, dilated cardiomyopathy
ACTC1	Hypertrophic cardiomyopathy, dilated cardiomyopathy
PRKAG2	Hypertrophic cardiomyopathy, dilated cardiomyopathy
GLA	Hypertrophic cardiomyopathy, dilated cardiomyopathy
MYL2	Hypertrophic cardiomyopathy, dilated cardiomyopathy
LMNA	Hypertrophic cardiomyopathy, dilated cardiomyopathy
RYR2	Catecholaminergic polymorphic ventricular tachycardia
PKP2	Arrhythmogenic right-ventricular cardiomyopathy
DSP	Arrhythmogenic right-ventricular cardiomyopathy
DSC2	Arrhythmogenic right-ventricular cardiomyopathy
TMEM43	Arrhythmogenic right-ventricular cardiomyopathy
DSG2	Arrhythmogenic right-ventricular cardiomyopathy
KCNQ1	Romano-Ward long QT syndrome types 1, 2, and 3, Brugada syndrome
KCNH2	Romano-Ward long QT syndrome types 1, 2, and 3, Brugada syndrome
SCN5A	Romano-Ward long QT syndrome types 1, 2, and 3, Brugada syndrome
LDLR	Familial hypercholesterolemia
APOB	Familial hypercholesterolemia
PKCSK9	Familial hypercholesterolemia
RYR1	Malignant hyperthermia susceptibility
CACNA1S	Malignant hyperthermia susceptibility